R 1920 1080
NO ./path_to_the_north_texture.xpm
SO ./path_to_the_south_texture.xpm
WE ./path_to_the_west_texture.xpm
EA ./path_to_the_east_texture.xpm
S ./path_to_the_sprite_texture.xpm
F 220,100,0
C 225,200,0

        1111111111111111111111111
        1000S00000110000000000001
        1011000001110000002000001
        1001000000000000000000001
111111111011000001110000000000001
100000000011000001111111111111111
11110111111111111100000010001
11110111111111011101010010001
11111111111111111111111111111

10002000000000001100000010001
10000000000000001101010010001
110000011101010111110111100111
11110111 1110101 111111010001
11111111 1111111 111111111111
