NO texture/666.xpm
SO texture/fenetre.xpm
EA texture/rose.xpm
WE texture/daaaanyyy.xpm
F 250,205,50
C 0,191,255


11111111111111111111111111
10000000000000000000000001
1000000N0000001000000000011111
100000000000010000000000000001
100000000000100000000000000001
100000000001000000000000000001
100000000010000000000000000001
100000000100000000000000000001
100000000000000000000000000001
10000000100000100000000000000111111111111
100000000100000100000000000000000011111111
10000000001000001000000000000000000011111111
100000000001000001000000000001100000011111111
10000000000010000010000000000111000000111111111
10000000000001000001000000000111100000000011111111
100000000000000000000000000001  11111000000011111111111111111111
100000000000000000000000000001     1111100000001111111000000001111
100000000111111111111000000001         11100000111111000000000000111
100000000100000000000000000001           11000000111000000111000001111
100000000111000010000000000001             1000000100000111111110000001
100000000001000010000000000001             10000010000111      1110000011
100000000001000010000000000001             100000100001          11000000111
100000000001111110000000000001             110000000011           1100000011
100000000000000000000000000111111           1100000011            1110000011
1000000000000000000000000000111111111111111111000000111111          100000011
10000000000001111111000000000000000000000000000000000001      11111111000011
10000000000001111111111000000000000000000000000000000001      1000000000001
10000000000001111111111000000000000000000000000000000001      1000000000001
11110000000000001111111000000000000000000000000000000001      1000001111111
11111000000000000001100000001111111111111111100000001111      1000001 
11111111000000000000000000001               10000001          1000001
10000000000001000000000000001               10000001          1000001
10000000000001111111111000001               1000000111111111111000001
10000000000001111111111000001               1000000000000000000000001
11110000000000001111111000001               1000000000000000000000001
11111000000000000001100000001               1111111111111111111111111
11111111000000000000000000001
11111111111000000000000000001
11111111111111111111111111111
