R 1920 1080
NO /Users/cguiot/stud/Cub3d/texture/test.xpm
SO ./path_to_the_south_texture.xpm
WE ./path_to_the_west_texture.xpm
EA ./path_to_the_east_texture.xpm
S ./path_to_the_sprite_texture.xpm
F 220,100,0
C 225,30,0

        11111111111111111111111111
        10000000011000000000000001
        10000000001000000000000001
        10000S00000000000000000001
1111111110000000001000000000000001
1000000000110000011111111111111111
11111111111111111100000010001
