R 1920 1080
NO /Users/cguiot/stud/Cub3d/texture/test.xpm
SO ./path_to_the_south_texture.xpm
WE ./path_to_the_west_texture.xpm
EA ./path_to_the_east_texture.xpm
S ./path_to_the_sprite_texture.xpm
F 220,100,0
C 225,30,0

        1111111111111111111111111
        1000000000110000000000001
        1011000001110000001111101
        1001000000000000S00000011
111111111011000001110000001111101
100000000011000001110111111111111
111111111111111111111111111111111
