NO ./textures/Nwall.xpm
SO ./textures/Swall.xpm
EA ./textures/Ewall.xpm
WE ./textures/Wwall.xpm
F 220,255,200
C 200,20,255

11111111111111111111111111111
10000000001000000000000000001
10110000010000000020000000001
10010000000000000000000000001
11111111101100000111000000001
1000000000110000011101111111
11110111111111011100000010001
11110111111111011101010010001
11000000110101011100000010001
10002000000000001100N00000001
10000000000000001101010010001
11000001110101011111011110001
11110111111101011101111010001
11111111111111111111111111111
