SO texture/NOP.xpm
NO texture/666.xpm
EA texture/rose.xpm
WE texture/daaaanyyy.xpm
F 200,     200,   250
C 110,110,255

11111111111111111111111111                                            1111111111111111111111111
10000000000000000000000001                                           110000000000000000000000111
100000000000000000000000011111                                   111100000000000000000000000000011
100000000000000000000000000001                                  10000000000000000000000000000000011
100000000000000000000000000001                               1110000000000000000000000000000000000111111111
100000000000000000000000000001                             111111000000000000000000000000000000000000000011
100000000000000000000000000001                            1111100000000011111111111111111000000000000000011
100000000000000000000000000001                         1110000000000011111111111111111111100000000000000011
100000000000000000000000000001                    11111000000000000011111111111111111111111000000000000001111
1000000010000010000000000000011111111111111111111111100000000000111111111111111111111111111110000000000000001111111111
1000000001000001000000000000000011111111111111111100000000000111111111111110000001111111111111000000000000000000000001
1000000000100000100000000000000000111111111111111110000000000111111111111100000000111111111111111100000000000000000001
1000000000010000010000000000011000011111111111111110000000111111111111111000000000011111111111111111110000000000000011
1000000000001000001000000000011100000111111111111111000000111111111111111000000000001111111111111111100000110000000011
1000000000000100000100000000011110000011111111111111000000111111111111111000000000000011111111111000000001110000000111
100000000000000000000000000001  11111000001111111111111000011111111111111110000000000000111111000000001111111100000011
100000000000000000000000000001     11111000011111111111100000011111111111111000000000000001100000000111111111100000111
100000000000000000000000000001         1110001111111111000110000011111111111110000000000000000000001111111111100000011
100000000000000000000000000001           11000111111110000111000001111111111111000000000000000000011111111111100000001
100000000000000000000000000001             100011100000111111111000001111111111110000000000000000011111111111000000001
100000000000010000000000000001             1000110000111       1100000111111111000000000000000000111111111100000000001
100000000000010000000000000001              100010001           110000011111111111000000000000000000000000000000000011
100000000000010000000000000001              110000011            11000000111111111110000000000000000000000000000111111
1000000N0000010000000000000111111           110000011             1110000011111110000000000000000000000000000011111111
1000000000000100000000000000111111111111111111000000111111          10000001111110000000000000000000000000000111111111
10000000000001111111000000000000000000000000000000000001      1111111100001111111110000000000000000000000000111111111
10000000000001111111111000000000000000000000000000000001      1000000000001111111110000000000000000000000001111111111
10000000000001111111111000000000000000000000000000000001      1000000000001111111100000000000000000111111111111111111
11110000000000001111111000000000000000000000000000000001      10000011111111111110000000000000001111111111111111111111
11111000000000000001100000001111111111111111100000001111      100000111111111110000000000000001111111111111111111111
11111111000000000000000000001               10000001          100000111111100000000000000011111111111111111111111111
10000000000001000000000000001               10000001          100000111100000000000001111111111111111111111111111111
10000000000001111111111000001               1000000111111111111000001110000000000001111111111111111111111111111111111
10000000000001111111111000001               100000000000000000000000000000000011111111111111111111111111111111111111
11110000000000001111111000001               100000000000000000000000000000000111111111111111111111111111111111111111
11110000000000000011100000001               100000000000000000000000000000011111111111111111111111111111111111111111
11111000000000000001100000001               11111111111111111111111111111111111111111111111111111111111111111111111111
11111111000000000000000000001
11111111111000000000000000001
11111111111111111111111111111
